        #########
        #     @##
        # $#$ ###
        # $  $###
        ##$ $ ###
######### $ # ###
#....  ## $  $  #
##...    $  $   #
#....  ##########
########        #