    #####         #
    #   #         #
    #$  #         #
  ###  $##        #
  #  $ $ #        #
### # ## #   ######
#   # ## #####  ..#
# $  $          ..#
##### ### #@##  ..#
    #     #########
    #######       #