        #####   #
        #   #####
        # #$##  #
        #     $ #
######### ###   #
#....  ## $  $###
#....    $ $$ ###
#....  ##$  $ @##
#########  $  ###
        # $ $  ##
        ### ## ##
          #    ##
          #######