           ########
           #  ....#
############  ....#
#    #  $ $   ....#
# $$$#$  $ #  ....#
#  $     $ #  ....#
# $$ #$ $ $########
#  $ #     #      #
## #########      #
#    #    ##      #
#     $   ##      #
#  $$#$$  @#      #
#    #    ##      #
###########       #