    #####         #
    #   #         #
    #$  #         #
  ###$ $##        #
  #  @ $ #        #
### # ## #   ######
#   # ## #####  ..#
# $ $           ..#
##### ### # ##  ..#
    #     #########
    #######       #
    #####         #
    #   #         #
    #$ $#         #
  ###   ##        #
  #   $  #        #
### #$## #   ######
#   # ## #####  .!#
# $             .@#
##### ### # ##  ..#
    #     #########
    #######       #
